D D D D C D M M D D D D D D D D D C D C 
D D T D D D M M D D D C D D D T D D D T 
D D D C D D D D D D D D D M M D D D D D 
T T D D C C D C D M M T D M M D D D D D 
D D T T D T D D D M M D D D D T D D C D 
D D D D D D C D C C D C D D D C D C D D 
D C T D T T C D C D M M D D D D D D D D 
D D D D D D T D D T M M D D D T C C T D 
C D D D D M M D D D D T D D D D D M M T 
D D C D D M M D D T C T D M M D C M M D 
D D D D D D D T D D D D D M M D T D D D 
D T D D M M D M M D T P M M M M D D T D 
D D D D M M D M M D D D M M M M D D D D 
D M M M M C M M D D D D M M D D D D D T 
D M M M M D M M D M M C M M T D M M D D 
C M M D M M D D D M M D D D D C M M M M 
D M M D M M D T D D D C D C D D D D M M 
D C D D T D M M D D T D M M D D D M M D 
D D D D D T M M D D D D M M D D C M M D 
C D D C D D D D T T T D D D T D D D D T 
