D D D D D C D D D D T D T T D D D D M M C T M M D T D D D T 
C T C T D M M D D T C D D D T D C D M M D T M M D D T T D D 
C M M T D M M D D D T D T D C D T T D T T T D T C D T T D D 
D M M D D D T D T D T C T T D D D D D M M D T D D C D D D D 
D D D T D M M T D D D D D D D D T D T M M D T D C D T D D T 
T D D D T M M T T M M T D D T D D D T T T D C D T T D C T T 
D D M M C D T D D M M C D T D T T T D D D D C D T M M M M D 
T T M M T D D T C D D M M T T C D M M C D T D T T M M M M C 
D D D D T C T T T T D M M D D D D M M D T T D D T T D D T D 
M M D D T D T M M D D T T D T M M T D D D D D D D C D T T D 
M M D T T M M M M T D T D D D M M D D D D T D C D D D D T D 
C T T T C M M T T D T D D T T T D D T D T D D D C T D T M M 
T D D T D C D D T T D T M M C D T T D T D D D T D D D C M M 
D T D D T T M M D T D D M M D D T M M T T D D D D D D D D C 
T T T D T T M M D D T D D T T T C M M D C D M M M M T T D D 
T T D D D T T D D T T T T D T D D T T T C T M M M M D D D D 
C T T D M M T T D D D T D T D D M M D D C D D T D D D T T D 
T D D D M M D D C T D D T D T D M M D D D T C T D T C D C T 
D T T D D D D T D D D D T D T D T T T D T T T D T C D D D D 
T D T T D D D D C D T T D T M M D T D D T T D C D D D T T D 
T T T C T D D T D D D T D T M M D C D T T D C T C D T D D T 
C D T T C D C T T D D D P C M M C D D T T T D D D D D T T T 
D D D T C D T D D D D D D D M M D C C D D D T T T D D C D D 
D T D D D D C T T D D D D T D T D D T D C C D D T C D D C T 
T T D T C D T M M D T T M M D C D T D T T T D T T T D T C T 
D C D T D C D M M T D T M M T T D T T T D T D M M D D D C D 
T D T D D D D D D T D C D T T D D T D D D D C M M T D T D T 
C D T T D D D D D T D T M M D T D T D T C T D T D D D D T D 
D D T T D D T M M T T D M M D T T D T T D T T D T T T C T T 
T T T D D D D M M D T D D T D D T D D D C D D C C D C D D T 
Sky: 2