DDCCDDDDTDTDDDDDDDDT
DDDDDMMDTDTDDTTTDDTD
CTDDDMMDMMDTDDMMCCTD
DDDTDDDTMMDMMDMMDDCD
DCDCDMMMMDDMMDTTTDDD
DCDDDMMMMDDDDDTDDDDD
CTTTDTDMMDTDDDDDDDDT
DMMDDDDMMCDCDDDDDTDC
DMMCMMDDTDDTDDDMMDTD
TCTTMMDTDTDDDDDMMDDD
DDDTDTCTDDTTMMMMDDDD
DCDDTTDTMMDDMMMMDDDD
DDDTDDCDMMTTDDDDCTDD
DCDTDTDCDDDTDDTDMMDC
CMMTTDDTDDDDDTCTMMDD
DMMTDDMMTTCTCCDDDDDD
DTCDDDMMDDDDDTDDDTDD
DDMMDDDDDTMMDDDCDTDT
DTMMDDDTDDMMDDDDCTDT
DDTTDDDDTTDDDDDDPTTD
Sky: 2